WWWWWWWWWWWWWWWWWWWWWWWW
W                      W
W  L                R  W
W                      W
W                      W
W                      W
W                      W
W                      W
W                      W
WWWWWWWWWW     WWWWWWWWW
W                      W
W  -              -    W
W                      W
W                      W
W                      W
W  -              -    W
W                      W
W                      W
W                      W
W                      W
W           -          W
W                      W
W                      W
WWWWWWWWWWWWWWWWWWWWWWWW